Name,CreateCount,CreateCountC,CreatePercent,AssigneeCount,AssigneeCountC,AssigneePercent,Involvement,ModifyCount,ModifyPercent,IncModifyCount,DecModifyCount
Owen O'Malley,285,17,0.05964912280701754,315,16,0.050793650793650794,2088,30,0.014367816091954023,27,3
Nigel Daley,113,20,0.17699115044247787,166,24,0.14457831325301204,1518,53,0.03491436100131752,45,8
Andrew Wang,84,8,0.09523809523809523,111,9,0.08108108108108109,1516,27,0.017810026385224276,20,7
Arun Murthy,97,13,0.13402061855670103,238,21,0.08823529411764706,1374,141,0.10262008733624454,80,61
Doug Cutting,28,4,0.14285714285714285,36,3,0.08333333333333333,1196,8,0.006688963210702341,5,3
Arun Murthy,101,14,0.13861386138613863,122,14,0.11475409836065574,1172,21,0.017918088737201365,13,8
Steve Loughran,228,19,0.08333333333333333,321,25,0.0778816199376947,1166,93,0.0797598627787307,14,79
Andrew Wang,38,1,0.02631578947368421,55,3,0.05454545454545454,1100,17,0.015454545454545455,4,13
Arun Murthy,6,0,0,12,2,0.16666666666666666,1068,6,0.0056179775280898875,4,2
Allen Wittenauer,116,14,0.1206896551724138,137,17,0.12408759124087591,1001,21,0.02097902097902098,11,10
Allen Wittenauer,56,4,0.07142857142857142,67,4,0.05970149253731343,929,11,0.011840688912809472,7,4
Vinod Kumar Vavilapalli,48,9,0.1875,104,10,0.09615384615384616,909,56,0.061606160616061605,34,22
Vinod Kumar Vavilapalli,197,28,0.14213197969543148,242,30,0.12396694214876033,879,45,0.051194539249146756,32,13
Allen Wittenauer,39,2,0.05128205128205128,40,1,0.025,874,1,0.0011441647597254005,0,1
Tsz-wo Sze,125,15,0.12,178,14,0.07865168539325842,785,53,0.06751592356687898,13,40
Wei-Chiu Chuang,144,11,0.0763888888888889,158,9,0.056962025316455694,699,14,0.020028612303290415,9,5
Tsz-wo Sze,169,31,0.1834319526627219,201,31,0.15422885572139303,669,32,0.04783258594917788,16,16
Jason Darrell Lowe,168,14,0.08333333333333333,188,13,0.06914893617021277,643,20,0.03110419906687403,15,5
Vinod Kumar Vavilapalli,53,9,0.16981132075471697,65,12,0.18461538461538463,618,12,0.019417475728155338,11,1
Kihwal Lee,177,15,0.0847457627118644,205,16,0.07804878048780488,615,28,0.04552845528455285,21,7
Thomas White,56,6,0.10714285714285714,59,6,0.1016949152542373,606,3,0.0049504950495049506,3,0
Akira Ajisaka,169,12,0.07100591715976332,216,14,0.06481481481481481,604,47,0.07781456953642384,29,18
Todd Lipcon,207,15,0.07246376811594203,225,17,0.07555555555555556,604,18,0.029801324503311258,15,3
Sunil G,86,10,0.11627906976744186,99,9,0.09090909090909091,590,13,0.022033898305084745,10,3
Arun Murthy,6,0,0,19,0,0,546,13,0.023809523809523808,8,5
Suresh Srinivas,60,5,0.08333333333333333,90,7,0.07777777777777778,540,30,0.05555555555555555,20,10
Wangda Tan,73,11,0.1506849315068493,126,12,0.09523809523809523,522,53,0.10153256704980843,38,15
Eli Collins,141,16,0.11347517730496454,160,16,0.1,508,19,0.03740157480314961,9,10
Devaraj Das,83,5,0.060240963855421686,103,7,0.06796116504854369,506,20,0.039525691699604744,16,4
Akira Ajisaka,88,4,0.045454545454545456,118,5,0.0423728813559322,504,30,0.05952380952380952,18,12
Arpit Agarwal,100,7,0.07,116,10,0.08620689655172414,492,16,0.032520325203252036,10,6
Konstantin Shvachko,133,9,0.06766917293233082,149,8,0.053691275167785234,487,16,0.03285420944558522,13,3
Jason Darrell Lowe,157,16,0.10191082802547771,170,17,0.1,480,13,0.027083333333333334,11,2
Chris Nauroth,119,6,0.05042016806722689,128,7,0.0546875,465,9,0.01935483870967742,3,6
Brahma Reddy Battula,119,21,0.17647058823529413,143,21,0.14685314685314685,464,24,0.05172413793103448,21,3
Thomas White,42,1,0.023809523809523808,49,3,0.061224489795918366,462,7,0.015151515151515152,3,4
Christopher Douglas,66,4,0.06060606060606061,79,4,0.05063291139240506,461,13,0.028199566160520606,7,6
Rohith Sharma K S,131,17,0.1297709923664122,146,17,0.11643835616438356,460,15,0.03260869565217391,7,8
Konstantin Shvachko,126,17,0.1349206349206349,137,17,0.12408759124087591,459,11,0.023965141612200435,11,0
Colin McCabe,124,4,0.03225806451612903,134,3,0.022388059701492536,454,10,0.022026431718061675,7,3
Aaron Myers,99,10,0.10101010101010101,109,12,0.11009174311926606,451,10,0.022172949002217297,3,7
Karthik Kambatla,72,9,0.125,125,10,0.08,448,53,0.11830357142857142,43,10
Junping Du,51,6,0.11764705882352941,67,8,0.11940298507462686,442,16,0.03619909502262444,14,2
Dhruba Borthakur,98,12,0.12244897959183673,123,15,0.12195121951219512,438,25,0.05707762557077625,21,4
Owen O'Malley,50,2,0.04,56,4,0.07142857142857142,436,6,0.013761467889908258,2,4
Chris Nauroth,126,7,0.05555555555555555,133,7,0.05263157894736842,427,7,0.01639344262295082,5,2
Jian He,83,4,0.04819277108433735,89,5,0.056179775280898875,425,6,0.01411764705882353,3,3
Daryn Sharp,113,5,0.04424778761061947,114,5,0.043859649122807015,414,1,0.0024154589371980675,1,0
Vinayakumar B,80,12,0.15,86,8,0.09302325581395349,411,6,0.014598540145985401,4,2
Raghu Angadi,99,19,0.1919191919191919,122,19,0.1557377049180328,408,23,0.056372549019607844,18,5
Suresh Srinivas,51,7,0.13725490196078433,68,7,0.10294117647058823,377,17,0.04509283819628647,11,6
Jing Zhao,59,6,0.1016949152542373,87,14,0.16091954022988506,359,28,0.07799442896935933,13,15
Ayush Saxena,46,0,0,52,1,0.019230769230769232,358,6,0.01675977653631285,3,3
Robert Joseph Evans,62,17,0.27419354838709675,78,18,0.23076923076923078,340,16,0.047058823529411764,9,7
Akira Ajisaka,79,7,0.08860759493670886,104,7,0.0673076923076923,336,25,0.0744047619047619,12,13
Eli Collins,66,5,0.07575757575757576,79,5,0.06329113924050633,336,13,0.03869047619047619,3,10
Íñigo Goiri,20,1,0.05,21,1,0.047619047619047616,334,1,0.0029940119760479044,0,1
Mahadev Konar,48,3,0.0625,89,10,0.11235955056179775,324,41,0.12654320987654322,37,4
Bibin Chundatt,143,23,0.16083916083916083,175,24,0.13714285714285715,321,32,0.09968847352024922,25,7
Todd Lipcon,116,5,0.04310344827586207,119,5,0.04201680672268908,314,3,0.009554140127388535,2,1
Hairong Kuang,109,18,0.1651376146788991,122,16,0.13114754098360656,311,13,0.04180064308681672,9,4
Robert Chansler,6,0,0,57,3,0.05263157894736842,302,51,0.16887417218543047,49,2
Amareshwari Sriramadasu,105,7,0.06666666666666667,111,7,0.06306306306306306,289,6,0.020761245674740483,6,0
Wei-Chiu Chuang,75,8,0.10666666666666667,80,7,0.0875,286,5,0.017482517482517484,3,2
Thomas Graves,140,24,0.17142857142857143,147,24,0.16326530612244897,284,7,0.02464788732394366,6,1
Daryn Sharp,80,6,0.075,84,6,0.07142857142857142,284,4,0.014084507042253521,4,0
Junping Du,15,1,0.06666666666666667,21,1,0.047619047619047616,282,6,0.02127659574468085,4,2
Haohui Mai,63,8,0.12698412698412698,78,8,0.10256410256410256,281,15,0.05338078291814947,8,7
Owen O'Malley,24,2,0.08333333333333333,24,1,0.041666666666666664,278,0,0,0,0
Harsh J,18,0,0,23,0,0,277,5,0.018050541516245487,1,4
Amareshwari Sriramadasu,102,13,0.12745098039215685,110,12,0.10909090909090909,270,8,0.02962962962962963,7,1
Uma Maheswara Rao G,64,6,0.09375,68,5,0.07352941176470588,267,4,0.0149812734082397,2,2
Todd Lipcon,114,18,0.15789473684210525,117,17,0.1452991452991453,256,3,0.01171875,3,0
Alejandro Abdelnur,84,6,0.07142857142857142,84,5,0.05952380952380952,245,0,0,0,0
Allen Wittenauer,29,5,0.1724137931034483,40,7,0.175,244,11,0.045081967213114756,3,8
Steve Loughran,58,7,0.1206896551724138,71,6,0.08450704225352113,243,13,0.053497942386831275,6,7
Christopher Douglas,18,4,0.2222222222222222,25,5,0.2,239,7,0.029288702928870293,4,3
Aaron Myers,31,2,0.06451612903225806,34,2,0.058823529411764705,237,3,0.012658227848101266,1,2
Szilard Nemeth,36,4,0.1111111111111111,39,4,0.10256410256410256,237,3,0.012658227848101266,2,1
Harsh J,21,1,0.047619047619047616,24,1,0.041666666666666664,233,3,0.012875536480686695,1,2
Colin McCabe,61,5,0.08196721311475409,65,5,0.07692307692307693,231,4,0.017316017316017316,1,3
Harsh J,22,0,0,23,0,0,228,1,0.0043859649122807015,0,1
Daniel Templeton,55,4,0.07272727272727272,59,4,0.06779661016949153,224,4,0.017857142857142856,2,2
Yongjun Zhang,94,9,0.09574468085106383,95,8,0.08421052631578947,224,1,0.004464285714285714,0,1
Karthik Kambatla,43,4,0.09302325581395349,53,5,0.09433962264150944,222,10,0.04504504504504504,7,3
Varun Saxena,62,3,0.04838709677419355,67,4,0.05970149253731343,220,5,0.022727272727272728,4,1
Brahma Reddy Battula,40,4,0.1,45,4,0.08888888888888889,219,5,0.0228310502283105,5,0
Zhijie Shen,73,3,0.0410958904109589,78,4,0.05128205128205128,217,5,0.02304147465437788,4,1
Naganarasimha G R,19,3,0.15789473684210525,23,4,0.17391304347826086,216,4,0.018518518518518517,3,1
Amar Kamat,99,12,0.12121212121212122,105,12,0.11428571428571428,216,6,0.027777777777777776,4,2
Thomas White,15,1,0.06666666666666667,18,1,0.05555555555555555,208,3,0.014423076923076924,1,2
Arpit Agarwal,45,2,0.044444444444444446,45,2,0.044444444444444446,205,0,0,0,0
Akira Ajisaka,44,2,0.045454545454545456,61,2,0.03278688524590164,205,17,0.08292682926829269,7,10
Hemanth Yamijala,72,15,0.20833333333333334,108,15,0.1388888888888889,204,36,0.17647058823529413,30,6
Sandy Ryza,73,5,0.0684931506849315,78,5,0.0641025641025641,199,5,0.02512562814070352,3,2
Prabhu Joseph,116,4,0.034482758620689655,118,4,0.03389830508474576,198,2,0.010101010101010102,1,1
Xiao Chen,47,6,0.1276595744680851,50,6,0.12,195,3,0.015384615384615385,2,1
Devaraj Kavali,73,9,0.1232876712328767,80,9,0.1125,194,7,0.03608247422680412,6,1
Xuan Gong,38,9,0.23684210526315788,39,8,0.20512820512820512,193,1,0.0051813471502590676,1,0
Sameer Paranjpye,7,0,0,22,3,0.13636363636363635,191,15,0.07853403141361257,8,7
Matthew Foley,14,1,0.07142857142857142,19,1,0.05263157894736842,190,5,0.02631578947368421,1,4
Alejandro Abdelnur,42,5,0.11904761904761904,45,5,0.1111111111111111,189,3,0.015873015873015872,2,1
Jason Darrell Lowe,51,5,0.09803921568627451,56,6,0.10714285714285714,188,5,0.026595744680851064,5,0
Siddharth Seth,56,11,0.19642857142857142,60,8,0.13333333333333333,188,4,0.02127659574468085,3,1
Yiqun Lin,92,5,0.05434782608695652,95,5,0.05263157894736842,185,3,0.016216216216216217,0,3
Matthew Foley,12,2,0.16666666666666666,16,2,0.125,182,4,0.02197802197802198,2,2
Karthik Kambatla,35,4,0.11428571428571428,44,4,0.09090909090909091,178,9,0.05056179775280899,8,1
Surendra Singh Lilhore,57,3,0.05263157894736842,60,3,0.05,177,3,0.01694915254237288,3,0
Konstantin Shvachko,11,1,0.09090909090909091,20,1,0.05,177,9,0.05084745762711865,3,6
Junping Du,26,4,0.15384615384615385,33,3,0.09090909090909091,175,7,0.04,5,2
Masatake Iwasaki,55,1,0.01818181818181818,58,1,0.017241379310344827,165,3,0.01818181818181818,1,2
Eric Yang,32,4,0.125,36,4,0.1111111111111111,164,4,0.024390243902439025,4,0
Dhruba Borthakur,26,3,0.11538461538461539,29,4,0.13793103448275862,160,3,0.01875,1,2
Tsuyoshi Ozawa,16,1,0.0625,18,1,0.05555555555555555,157,2,0.012738853503184714,2,0
Mahadev Konar,43,0,0,47,0,0,156,4,0.02564102564102564,4,0
Konstantin I Boudnik,46,3,0.06521739130434782,49,3,0.061224489795918366,155,3,0.01935483870967742,3,0
Weiwei Yang,27,2,0.07407407407407407,40,2,0.05,155,13,0.08387096774193549,8,5
Jitendra Nath Pandey,29,1,0.034482758620689655,34,1,0.029411764705882353,154,5,0.032467532467532464,4,1
Amar Kamat,57,10,0.17543859649122806,62,10,0.16129032258064516,154,5,0.032467532467532464,5,0
Eric Yang,58,4,0.06896551724137931,63,4,0.06349206349206349,153,5,0.032679738562091505,4,1
Robert Joseph Evans,23,2,0.08695652173913043,24,2,0.08333333333333333,152,1,0.006578947368421052,0,1
Steve Loughran,47,5,0.10638297872340426,51,5,0.09803921568627451,152,4,0.02631578947368421,1,3
Kihwal Lee,40,5,0.125,47,6,0.1276595744680851,151,7,0.046357615894039736,7,0
Brahma Reddy Battula,21,4,0.19047619047619047,28,6,0.21428571428571427,151,7,0.046357615894039736,7,0
Mingliang Liu,27,2,0.07407407407407407,31,2,0.06451612903225806,151,4,0.026490066225165563,2,2
Xiaoyu Yao,38,6,0.15789473684210525,39,6,0.15384615384615385,150,1,0.006666666666666667,1,0
Ravi Gummadi,57,3,0.05263157894736842,58,2,0.034482758620689655,147,1,0.006802721088435374,0,1
Eric Payne,26,2,0.07692307692307693,28,2,0.07142857142857142,145,2,0.013793103448275862,2,0
Yufei Gu,56,2,0.03571428571428571,58,2,0.034482758620689655,145,2,0.013793103448275862,2,0
Haibo Chen,51,3,0.058823529411764705,54,3,0.05555555555555555,145,3,0.020689655172413793,2,1
Junping Du,18,2,0.1111111111111111,24,2,0.08333333333333333,141,6,0.0425531914893617,5,1
Lohit Vijaya Renu,60,11,0.18333333333333332,61,10,0.16393442622950818,138,1,0.007246376811594203,1,0
Nigel Daley,15,0,0,22,6,0.2727272727272727,136,7,0.051470588235294115,1,6
Vinayakumar B,42,2,0.047619047619047616,47,2,0.0425531914893617,136,5,0.03676470588235294,2,3
Jakob Homan,27,1,0.037037037037037035,29,1,0.034482758620689655,134,2,0.014925373134328358,0,2
Rushabh Shah,49,3,0.061224489795918366,49,3,0.061224489795918366,133,0,0,0,0
Brandon Li,53,1,0.018867924528301886,55,1,0.01818181818181818,133,2,0.015037593984962405,1,1
Haohui Mai,26,4,0.15384615384615385,28,4,0.14285714285714285,131,2,0.015267175572519083,1,1
Koji Noguchi,80,25,0.3125,85,25,0.29411764705882354,131,5,0.03816793893129771,3,2
Arun Suresh,35,0,0,36,0,0,131,1,0.007633587786259542,1,0
Eli Collins,26,4,0.15384615384615385,31,5,0.16129032258064516,130,5,0.038461538461538464,4,1
Hitesh Shah,40,3,0.075,47,7,0.14893617021276595,129,7,0.05426356589147287,6,1
Lei (Eddy) Xu,36,2,0.05555555555555555,38,3,0.07894736842105263,128,2,0.015625,1,1
Xiaoqiao He,17,2,0.11764705882352941,17,2,0.11764705882352941,127,0,0,0,0
Tsuyoshi Ozawa,20,3,0.15,23,4,0.17391304347826086,127,3,0.023622047244094488,2,1
Masatake Iwasaki,20,1,0.05,23,1,0.043478260869565216,126,3,0.023809523809523808,0,3
Xiao Chen,33,2,0.06060606060606061,37,2,0.05405405405405406,124,4,0.03225806451612903,1,3
Miklos Szegedi,60,4,0.06666666666666667,61,4,0.06557377049180328,124,1,0.008064516129032258,1,0
Devaraj Das,27,2,0.07407407407407407,31,3,0.0967741935483871,123,4,0.032520325203252036,2,2
Hemanth Yamijala,28,3,0.10714285714285714,29,3,0.10344827586206896,123,1,0.008130081300813009,0,1
Thomas Graves,46,7,0.15217391304347827,51,5,0.09803921568627451,119,5,0.04201680672268908,4,1
Jonathan Turner Eagles,42,6,0.14285714285714285,45,6,0.13333333333333333,114,3,0.02631578947368421,2,1
Steve Loughran,37,2,0.05405405405405406,44,2,0.045454545454545456,114,7,0.06140350877192982,2,5
Runping Qi,76,14,0.18421052631578946,76,12,0.15789473684210525,113,0,0,0,0
Robert Kanter,30,2,0.06666666666666667,30,1,0.03333333333333333,111,0,0,0,0
Eric Badger,20,0,0,20,0,0,110,0,0,0,0
Hemanth Boyina,43,1,0.023255813953488372,44,1,0.022727272727272728,109,1,0.009174311926605505,1,0
Ravi Prakash,34,4,0.11764705882352941,39,4,0.10256410256410256,107,5,0.04672897196261682,5,0
Ivan Mitic,54,2,0.037037037037037035,54,2,0.037037037037037035,106,0,0,0,0
Varun Vasudev,20,2,0.1,22,2,0.09090909090909091,104,2,0.019230769230769232,2,0
Mingliang Liu,25,3,0.12,28,3,0.10714285714285714,104,3,0.028846153846153848,2,1
Jakob Homan,25,0,0,25,0,0,104,0,0,0,0
Hairong Kuang,41,11,0.2682926829268293,52,10,0.19230769230769232,104,11,0.10576923076923077,8,3
Sandy Ryza,45,2,0.044444444444444446,47,2,0.0425531914893617,103,2,0.019417475728155338,1,1
John Zhuge,53,6,0.11320754716981132,55,4,0.07272727272727272,103,2,0.019417475728155338,0,2
Yesha Vora,101,5,0.04950495049504951,101,4,0.039603960396039604,103,0,0,0,0
Zhe Zhang,31,2,0.06451612903225806,31,2,0.06451612903225806,101,0,0,0,0
Zhihai Xu,47,7,0.14893617021276595,52,7,0.1346153846153846,100,5,0.05,1,4
Bikas Saha,31,6,0.1935483870967742,36,6,0.16666666666666666,99,5,0.050505050505050504,4,1
Jitendra Nath Pandey,24,1,0.041666666666666664,25,1,0.04,98,1,0.01020408163265306,1,0
Devaraj Kavali,32,7,0.21875,36,5,0.1388888888888889,98,4,0.04081632653061224,3,1
Andras Bokor,23,4,0.17391304347826086,26,4,0.15384615384615385,98,3,0.030612244897959183,1,2
Hitesh Shah,27,7,0.25925925925925924,37,9,0.24324324324324326,98,10,0.10204081632653061,8,2
Erik Krogen,22,2,0.09090909090909091,25,2,0.08,98,3,0.030612244897959183,3,0
Wangda Tan,8,0,0,11,0,0,98,3,0.030612244897959183,2,1
Ramya Sunil,89,32,0.3595505617977528,90,29,0.32222222222222224,97,1,0.010309278350515464,1,0
Giridharan Kesavan,34,1,0.029411764705882353,34,1,0.029411764705882353,96,0,0,0,0
Sangjin Lee,16,3,0.1875,17,3,0.17647058823529413,95,1,0.010526315789473684,0,1
Thomas Graves,19,1,0.05263157894736842,22,1,0.045454545454545456,95,3,0.031578947368421054,1,2
Omkar Vinit Joshi,24,4,0.16666666666666666,27,4,0.14814814814814814,93,3,0.03225806451612903,2,1
Uma Maheswara Rao G,21,1,0.047619047619047616,23,1,0.043478260869565216,93,2,0.021505376344086023,0,2
Chuan Liu,42,0,0,42,0,0,92,0,0,0,0
Chris Nauroth,29,0,0,30,0,0,92,1,0.010869565217391304,0,1
Alejandro Abdelnur,36,0,0,37,0,0,92,1,0.010869565217391304,1,0
Bilwa S T,32,2,0.0625,34,2,0.058823529411764705,91,2,0.02197802197802198,0,2
Tsz-wo Sze,22,1,0.045454545454545456,25,1,0.04,91,3,0.03296703296703297,0,3
Mukund Madhugiri,52,7,0.1346153846153846,58,7,0.1206896551724138,89,6,0.06741573033707865,6,0
Konstantin I Boudnik,23,1,0.043478260869565216,25,1,0.04,89,2,0.02247191011235955,2,0
Takanobu Asanuma,18,2,0.1111111111111111,22,2,0.09090909090909091,88,4,0.045454545454545456,3,1
Tao Yang,57,8,0.14035087719298245,58,7,0.1206896551724138,88,1,0.011363636363636364,0,1
Christian Kunz,64,22,0.34375,70,22,0.3142857142857143,87,6,0.06896551724137931,5,1
Walter Su,19,1,0.05263157894736842,22,1,0.045454545454545456,86,3,0.03488372093023256,1,2
Yi Liu,23,2,0.08695652173913043,27,3,0.1111111111111111,86,4,0.046511627906976744,2,2
John Zhuge,27,1,0.037037037037037035,28,1,0.03571428571428571,86,1,0.011627906976744186,0,1
Adam Antal,21,0,0,21,0,0,84,0,0,0,0
Alejandro Abdelnur,25,1,0.04,25,1,0.04,83,0,0,0,0
Peter Bacsko,24,1,0.041666666666666664,25,1,0.04,83,1,0.012048192771084338,0,1
Xiaoyu Yao,31,2,0.06451612903225806,32,2,0.0625,80,1,0.0125,1,0
Ravi Prakash,20,2,0.1,22,2,0.09090909090909091,80,2,0.025,1,1
Stephen O'Donnell,22,0,0,22,0,0,80,0,0,0,0
Haibo Chen,21,0,0,24,1,0.041666666666666664,79,3,0.0379746835443038,0,3
Milind Barve,15,1,0.06666666666666667,18,2,0.1111111111111111,79,3,0.0379746835443038,2,1
J.Andreina,62,7,0.11290322580645161,62,7,0.11290322580645161,79,0,0,0,0
Billie Rinaldi,20,1,0.05,26,1,0.038461538461538464,79,6,0.0759493670886076,6,0
Chen Liang,12,1,0.08333333333333333,12,1,0.08333333333333333,79,0,0,0,0
Ravi Prakash,11,0,0,13,0,0,76,2,0.02631578947368421,2,0
Ray Chiang,17,1,0.058823529411764705,17,1,0.058823529411764705,76,0,0,0,0
Gera Shegalov,22,1,0.045454545454545456,24,1,0.041666666666666664,75,2,0.02666666666666667,2,0
Chris Nauroth,27,1,0.037037037037037035,27,1,0.037037037037037035,74,0,0,0,0
Anubhav Dhoot,46,7,0.15217391304347827,46,7,0.15217391304347827,74,0,0,0,0
Robert Kanter,24,0,0,25,0,0,72,1,0.013888888888888888,1,0
Konstantin I Boudnik,20,1,0.05,21,1,0.047619047619047616,72,1,0.013888888888888888,1,0
Arun Suresh,27,1,0.037037037037037035,28,1,0.03571428571428571,72,1,0.013888888888888888,0,1
Jonathan Hung,19,0,0,19,0,0,71,0,0,0,0
Sanjay Radia,12,2,0.16666666666666666,12,2,0.16666666666666666,69,0,0,0,0
Subramaniam Krishnan,7,0,0,12,0,0,69,5,0.07246376811594203,3,2
Jim Brennan,16,0,0,16,0,0,69,0,0,0,0
Hanisha Koneru,24,1,0.041666666666666664,24,0,0,68,0,0,0,0
Li Lu,12,1,0.08333333333333333,13,1,0.07692307692307693,67,1,0.014925373134328358,1,0
Arpit Gupta,55,5,0.09090909090909091,55,4,0.07272727272727272,67,0,0,0,0
Jing Zhao,10,2,0.2,12,2,0.16666666666666666,66,2,0.030303030303030304,1,1
Jason Darrell Lowe,20,1,0.05,21,1,0.047619047619047616,66,1,0.015151515151515152,1,0
Sangjin Lee,19,3,0.15789473684210525,21,2,0.09523809523809523,66,2,0.030303030303030304,1,1
Rakesh Radhakrishnan,26,1,0.038461538461538464,26,1,0.038461538461538464,66,0,0,0,0
Ahmed Radwan,39,4,0.10256410256410256,39,3,0.07692307692307693,65,0,0,0,0
Anu Engineer,12,3,0.25,12,3,0.25,65,0,0,0,0
Jonathan Turner Eagles,20,1,0.05,21,1,0.047619047619047616,65,1,0.015384615384615385,1,0
Enis Soztutar,9,2,0.2222222222222222,12,2,0.16666666666666666,65,3,0.046153846153846156,3,0
Aaron Kimball,38,1,0.02631578947368421,39,0,0,65,1,0.015384615384615385,0,1
Robert Joseph Evans,13,1,0.07692307692307693,13,1,0.07692307692307693,64,0,0,0,0
Andy Isaacson,31,0,0,31,0,0,64,0,0,0,0
Chao Sun,15,0,0,16,0,0,64,1,0.015625,1,0
Raghu Angadi,13,4,0.3076923076923077,15,4,0.26666666666666666,64,2,0.03125,0,2
Luke Lu,17,0,0,18,0,0,63,1,0.015873015873015872,1,0
Yongjun Zhang,29,0,0,29,0,0,62,0,0,0,0
sandflee,38,3,0.07894736842105263,38,3,0.07894736842105263,62,0,0,0,0
Bharat Viswanadham,21,0,0,21,0,0,61,0,0,0,0
Luke Lu,10,1,0.1,10,1,0.1,61,0,0,0,0
Hui Fei,17,3,0.17647058823529413,18,3,0.16666666666666666,60,1,0.016666666666666666,1,0
Ted Yu,51,3,0.058823529411764705,54,3,0.05555555555555555,60,3,0.05,3,0
Jonathan Turner Eagles,17,2,0.11764705882352941,17,2,0.11764705882352941,60,0,0,0,0
Michael Stack,25,3,0.12,29,3,0.10344827586206896,59,4,0.06779661016949153,4,0
Bikas Saha,9,1,0.1111111111111111,10,1,0.1,58,1,0.017241379310344827,0,1
Akhil PB,29,3,0.10344827586206896,30,3,0.1,58,1,0.017241379310344827,1,0
Ted Yu,42,6,0.14285714285714285,42,6,0.14285714285714285,57,0,0,0,0
Bikas Saha,23,0,0,24,0,0,57,1,0.017543859649122806,1,0
Jothi Padmanabhan,21,3,0.14285714285714285,21,3,0.14285714285714285,57,0,0,0,0
Thomas Graves,12,2,0.16666666666666666,12,2,0.16666666666666666,56,0,0,0,0
Siddharth Seth,15,0,0,15,0,0,55,0,0,0,0
Sreekanth Ramakrishnan,18,3,0.16666666666666666,18,3,0.16666666666666666,55,0,0,0,0
Giovanni Matteo Fumarola,14,1,0.07142857142857142,15,0,0,55,1,0.01818181818181818,0,1
Daryn Sharp,11,0,0,11,0,0,54,0,0,0,0
Ming Ma,24,1,0.041666666666666664,24,1,0.041666666666666664,54,0,0,0,0
Shane Kumpf,16,3,0.1875,16,3,0.1875,54,0,0,0,0
Qi Zhu,16,1,0.0625,17,1,0.058823529411764705,53,1,0.018867924528301886,1,0
Rohith Sharma K S,14,1,0.07142857142857142,15,1,0.06666666666666667,53,1,0.018867924528301886,1,0
Zhijie Shen,20,2,0.1,21,2,0.09523809523809523,53,1,0.018867924528301886,1,0
Hong Tang,22,2,0.09090909090909091,27,2,0.07407407407407407,53,5,0.09433962264150944,5,0
Larry McCay,16,0,0,16,0,0,52,0,0,0,0
Sean Busbey,15,0,0,17,0,0,52,2,0.038461538461538464,1,1
Brahma Reddy Battula,11,3,0.2727272727272727,13,3,0.23076923076923078,52,2,0.038461538461538464,2,0
Wei-Chiu Chuang,9,2,0.2222222222222222,11,2,0.18181818181818182,52,2,0.038461538461538464,1,1
Arpit Gupta,33,4,0.12121212121212122,33,4,0.12121212121212122,51,0,0,0,0
Robert Kanter,15,2,0.13333333333333333,17,2,0.11764705882352941,51,2,0.0392156862745098,1,1
Wei Yan,14,3,0.21428571428571427,15,3,0.2,51,1,0.0196078431372549,0,1
Mukul Kumar Singh,24,1,0.041666666666666664,24,1,0.041666666666666664,50,0,0,0,0
Manoj Govindassamy,24,0,0,25,0,0,50,1,0.02,0,1
Boris Shkolnik,25,0,0,25,0,0,50,0,0,0,0
Íñigo Goiri,12,0,0,12,0,0,50,0,0,0,0
Yoram Arnon,30,0,0,30,0,0,49,0,0,0,0
Karam Singh,41,12,0.2926829268292683,43,10,0.23255813953488372,49,2,0.04081632653061224,1,1
Boris Shkolnik,21,1,0.047619047619047616,21,1,0.047619047619047616,49,0,0,0,0
Charles Lamb,28,2,0.07142857142857142,28,2,0.07142857142857142,48,0,0,0,0
Eric Payne,7,1,0.14285714285714285,10,1,0.1,48,3,0.0625,3,0
Bhallamudi Venkata Siva Kamesh,24,3,0.125,25,3,0.12,48,1,0.020833333333333332,1,0
Sumana Sathish,47,6,0.1276595744680851,47,5,0.10638297872340426,47,0,0,0,0
Tarun Parimi,29,0,0,29,0,0,45,0,0,0,0
Zhihai Xu,18,2,0.1111111111111111,20,2,0.1,45,2,0.044444444444444446,2,0
Dick King,20,1,0.05,20,1,0.05,44,0,0,0,0
Chandni Singh,24,3,0.125,24,3,0.125,44,0,0,0,0
Suma Shivaprasad,17,1,0.058823529411764705,17,1,0.058823529411764705,43,0,0,0,0
Sangjin Lee,18,2,0.1111111111111111,20,2,0.1,42,2,0.047619047619047616,1,1
Masatake Iwasaki,12,1,0.08333333333333333,13,1,0.07692307692307693,41,1,0.024390243902439025,0,1
Kihwal Lee,16,3,0.1875,18,3,0.16666666666666666,40,2,0.05,2,0
Jian He,14,0,0,15,0,0,40,1,0.025,0,1
Gour Saha,12,2,0.16666666666666666,13,2,0.15384615384615385,39,1,0.02564102564102564,1,0
Jun Gong,21,1,0.047619047619047616,21,1,0.047619047619047616,38,0,0,0,0
kyungwan nam,35,0,0,35,0,0,38,0,0,0,0
Iyappan Srinivasan,26,1,0.038461538461538464,26,1,0.038461538461538464,37,0,0,0,0
Xuan Gong,10,0,0,10,0,0,37,0,0,0,0
Peter Bacsko,17,0,0,17,0,0,36,0,0,0,0
Giridharan Kesavan,15,1,0.06666666666666667,16,1,0.0625,36,1,0.027777777777777776,1,0
