Name,CreateCount,CreateCountC,CreatePercent,AssigneeCount,AssigneeCountC,AssigneePercent,Involvement,ModifyCount,ModifyPercent,IncModifyCount,DecModifyCount
Ashutosh Chauhan,234,1,0.004273504273504274,234,1,0.004273504273504274,3336,0,0,0,0
Sergey Shelukhin,758,23,0.030343007915567283,784,24,0.030612244897959183,1999,26,0.013006503251625813,22,4
Thejas Nair,286,14,0.04895104895104895,310,14,0.04516129032258064,1895,24,0.012664907651715039,19,5
Peter Vary,89,2,0.02247191011235955,91,2,0.02197802197802198,1650,2,0.0012121212121212121,1,1
Jesus Camacho Rodriguez,307,7,0.02280130293159609,323,7,0.021671826625386997,1394,16,0.011477761836441894,14,2
Carl Steinbach,174,9,0.05172413793103448,192,9,0.046875,1332,18,0.013513513513513514,11,7
Owen O'Malley,87,5,0.05747126436781609,92,5,0.05434782608695652,1110,5,0.0045045045045045045,4,1
Prasanth Jayachandran,414,12,0.028985507246376812,430,12,0.027906976744186046,1000,16,0.016,12,4
Lefty Leverenz,23,1,0.043478260869565216,24,1,0.041666666666666664,939,1,0.0010649627263045794,1,0
Gopal Vijayaraghavan,374,16,0.0427807486631016,386,16,0.04145077720207254,924,12,0.012987012987012988,7,5
Namit Jain,318,11,0.03459119496855346,329,13,0.03951367781155015,843,11,0.013048635824436536,11,0
Vineet Garg,74,1,0.013513513513513514,75,1,0.013333333333333334,815,1,0.001226993865030675,0,1
Gunther Hagleitner,250,3,0.012,276,5,0.018115942028985508,807,26,0.0322180916976456,19,7
Eugene Koifman,369,31,0.08401084010840108,411,32,0.07785888077858881,718,42,0.0584958217270195,37,5
Brock Noland,140,0,0,144,2,0.013888888888888888,664,4,0.006024096385542169,4,0
Sushanth Sowmyan,99,9,0.09090909090909091,108,10,0.09259259259259259,647,9,0.013910355486862442,3,6
Navis Ryu,123,4,0.032520325203252036,128,4,0.03125,631,5,0.00792393026941363,5,0
Xuefu Zhang,100,1,0.01,105,1,0.009523809523809525,627,5,0.007974481658692184,3,2
Zoltan Haindrich,244,0,0,245,0,0,619,1,0.0016155088852988692,1,0
Jason Dere,235,1,0.00425531914893617,237,1,0.004219409282700422,600,2,0.0033333333333333335,2,0
Alan Gates,132,6,0.045454545454545456,141,6,0.0425531914893617,440,9,0.020454545454545454,7,2
Matt McCline,261,8,0.03065134099616858,267,8,0.0299625468164794,437,6,0.013729977116704805,4,2
Vikram Dixit K,138,11,0.07971014492753623,162,13,0.08024691358024691,412,24,0.05825242718446602,22,2
Zheng Shao,128,7,0.0546875,138,5,0.036231884057971016,388,10,0.02577319587628866,8,2
Vaibhav Gumashta,169,14,0.08284023668639054,190,14,0.07368421052631578,377,21,0.05570291777188329,16,5
Pengcheng Xiong,84,0,0,86,0,0,366,2,0.00546448087431694,2,0
Szehon Ho,86,3,0.03488372093023256,88,2,0.022727272727272728,342,2,0.005847953216374269,1,1
Aihua Xu,106,1,0.009433962264150943,107,1,0.009345794392523364,290,1,0.0034482758620689655,0,1
Daniel Dai,128,0,0,128,0,0,281,0,0,0,0
Sergio Peña,50,0,0,53,0,0,262,3,0.011450381679389313,1,2
John Sichi,40,2,0.05,41,1,0.024390243902439025,253,1,0.003952569169960474,1,0
Siddharth Seth,60,3,0.05,66,2,0.030303030303030304,237,6,0.02531645569620253,6,0
Edward Capriolo,26,4,0.15384615384615385,42,4,0.09523809523809523,230,16,0.06956521739130435,16,0
Harish Butani,76,2,0.02631578947368421,77,2,0.025974025974025976,224,1,0.004464285714285714,0,1
He Yongqiang,75,1,0.013333333333333334,75,1,0.013333333333333334,217,0,0,0,0
Vihang Karajgaonkar,56,1,0.017857142857142856,56,1,0.017857142857142856,211,0,0,0,0
Hari Sankar Sivarama Subramaniyan,121,1,0.008264462809917356,121,1,0.008264462809917356,208,0,0,0,0
Chaoyu Tang,87,1,0.011494252873563218,87,1,0.011494252873563218,201,0,0,0,0
Naveen Gangam,61,1,0.01639344262295082,61,1,0.01639344262295082,198,0,0,0,0
Ashish Thusoo,21,3,0.14285714285714285,44,7,0.1590909090909091,193,23,0.11917098445595854,20,3
Stamatis Zampetakis,52,0,0,53,0,0,189,1,0.005291005291005291,1,0
Ning Zhang,69,4,0.057971014492753624,69,4,0.057971014492753624,187,0,0,0,0
Yongzhi Chen,75,2,0.02666666666666667,78,2,0.02564102564102564,186,3,0.016129032258064516,1,2
László Bodor,80,0,0,80,0,0,178,0,0,0,0
Rajesh Balamohan,139,10,0.07194244604316546,143,10,0.06993006993006994,178,4,0.02247191011235955,0,4
Rui Li,63,2,0.031746031746031744,65,2,0.03076923076923077,176,2,0.011363636363636364,1,1
Chao Sun,65,2,0.03076923076923077,65,1,0.015384615384615385,170,0,0,0,0
Wei Zheng,74,4,0.05405405405405406,74,4,0.05405405405405406,165,0,0,0,0
Sankar Hariappan,49,2,0.04081632653061224,52,2,0.038461538461538464,158,3,0.0189873417721519,2,1
Sahil Takiar,50,0,0,50,0,0,156,0,0,0,0
Kevin Wilfong,72,1,0.013888888888888888,73,1,0.0136986301369863,156,1,0.00641025641025641,1,0
mahesh kumar behera,77,0,0,77,0,0,135,0,0,0,0
Slim Bouguerra,74,0,0,74,0,0,127,0,0,0,0
Damien Carol,11,2,0.18181818181818182,11,1,0.09090909090909091,125,0,0,0,0
Joydeep Sen Sarma,62,2,0.03225806451612903,68,3,0.04411764705882353,124,6,0.04838709677419355,5,1
Prasad Suresh Mujumdar,46,1,0.021739130434782608,47,1,0.02127659574468085,123,1,0.008130081300813009,1,0
Mithun Radhakrishnan,80,3,0.0375,81,3,0.037037037037037035,122,1,0.00819672131147541,1,0
Prasad Chakka,41,1,0.024390243902439025,41,1,0.024390243902439025,121,0,0,0,0
Jimmy Xiang,60,6,0.1,63,6,0.09523809523809523,117,3,0.02564102564102564,0,3
Laljo John Pullokkaran,33,0,0,34,0,0,115,1,0.008695652173913044,1,0
Anishek Agarwal,49,2,0.04081632653061224,51,2,0.0392156862745098,113,2,0.017699115044247787,0,2
Alexander Pivovarov,54,0,0,54,0,0,111,0,0,0,0
Chinna Rao Lalam,55,3,0.05454545454545454,57,3,0.05263157894736842,111,2,0.018018018018018018,2,0
Krisztian Kasa,68,0,0,68,0,0,106,0,0,0,0
Ferdinand Xu,16,0,0,17,0,0,105,1,0.009523809523809525,1,0
Deepak Jaiswal,66,0,0,66,0,0,104,0,0,0,0
Mostafa Mokhtar,69,9,0.13043478260869565,71,8,0.11267605633802817,104,2,0.019230769230769232,0,2
Teddy Choi,21,3,0.14285714285714285,23,3,0.13043478260869565,104,2,0.019230769230769232,1,1
David Mollitor,23,3,0.13043478260869565,28,3,0.10714285714285714,102,5,0.049019607843137254,1,4
Rajkumar Singh,67,0,0,67,0,0,100,0,0,0,0
Karen Coppage,49,0,0,49,0,0,92,0,0,0,0
Paul Yang,36,1,0.027777777777777776,36,1,0.027777777777777776,90,0,0,0,0
Ádám Szita,54,0,0,54,0,0,88,0,0,0,0
Raghotham Murthy,20,0,0,20,0,0,78,0,0,0,0
Amareshwari Sriramadasu,26,0,0,28,0,0,78,2,0.02564102564102564,0,2
Miklos Gergely,46,0,0,46,0,0,75,0,0,0,0
Panagiotis Garefalakis,14,0,0,14,0,0,73,0,0,0,0
Marta Kuczora,39,0,0,39,0,0,69,0,0,0,0
Denys Kuzmenko,31,0,0,31,0,0,68,0,0,0,0
Zhenxiao Luo,38,0,0,38,0,0,67,0,0,0,0
Swarnim Kulkarni,15,0,0,16,0,0,67,1,0.014925373134328358,1,0
Mohit Sabharwal,31,0,0,31,0,0,65,0,0,0,0
Anthony Hsu,12,1,0.08333333333333333,12,1,0.08333333333333333,64,0,0,0,0
Deepesh Khandelwal,52,1,0.019230769230769232,52,1,0.019230769230769232,64,0,0,0,0
Alex Kolbasov,26,0,0,26,0,0,62,0,0,0,0
Carter Shanklin,37,0,0,37,0,0,60,0,0,0,0
