Name,CreateCount,CreateCountC,CreatePercent,AssigneeCount,AssigneeCountC,AssigneePercent,Involvement,ModifyCount,ModifyPercent,IncModifyCount,DecModifyCount
Guozhang Wang,192,16,0.08333333333333333,231,19,0.08225108225108226,1263,39,0.030878859857482184,36,3
Ismael Juma,86,6,0.06976744186046512,202,18,0.0891089108910891,1200,116,0.09666666666666666,102,14
Jun Rao,250,25,0.1,290,27,0.09310344827586207,1096,40,0.0364963503649635,36,4
Matthias J. Sax,225,18,0.08,283,24,0.08480565371024736,929,58,0.062432723358449946,36,22
Jason Gustafson,274,15,0.05474452554744526,298,15,0.050335570469798654,814,24,0.029484029484029485,20,4
Neha Narkhede,122,5,0.040983606557377046,159,12,0.07547169811320754,728,37,0.050824175824175824,31,6
Manikumar,19,3,0.15789473684210525,24,3,0.125,691,5,0.00723589001447178,2,3
Ewen Cheslack-Postava,120,11,0.09166666666666666,148,11,0.07432432432432433,568,28,0.04929577464788732,17,11
Gwen Shapira,84,5,0.05952380952380952,101,5,0.04950495049504951,412,17,0.0412621359223301,7,10
Rajini Sivaram,117,7,0.05982905982905983,126,7,0.05555555555555555,409,9,0.022004889975550123,8,1
Jay Kreps,57,9,0.15789473684210525,61,8,0.13114754098360656,363,4,0.011019283746556474,3,1
Randall Hauch,41,4,0.0975609756097561,58,4,0.06896551724137931,282,17,0.06028368794326241,14,3
Joel Jacob Koshy,80,8,0.1,97,8,0.08247422680412371,274,17,0.06204379562043796,17,0
Colin McCabe,93,1,0.010752688172043012,104,3,0.028846153846153848,270,11,0.040740740740740744,7,4
A. Sophie Blee-Goldman,101,11,0.10891089108910891,118,11,0.09322033898305085,267,17,0.06367041198501873,15,2
huxihx,24,2,0.08333333333333333,25,2,0.08,232,1,0.004310344827586207,0,1
John Roesler,44,11,0.25,80,17,0.2125,203,36,0.17733990147783252,23,13
Joe Stein,53,5,0.09433962264150944,59,5,0.0847457627118644,193,6,0.031088082901554404,5,1
Bill Bejeck,28,2,0.07142857142857142,35,2,0.05714285714285714,192,7,0.036458333333333336,4,3
Damian Guy,50,2,0.04,51,2,0.0392156862745098,187,1,0.0053475935828877,0,1
Dong Lin,57,6,0.10526315789473684,66,8,0.12121212121212122,162,9,0.05555555555555555,7,2
Bruno Cadonna,17,5,0.29411764705882354,23,5,0.21739130434782608,159,6,0.03773584905660377,4,2
Jiangjie Qin,65,11,0.16923076923076924,71,10,0.14084507042253522,154,6,0.03896103896103896,5,1
Vahid Hashemian,22,0,0,22,0,0,154,0,0,0,0
Luke Chen,27,6,0.2222222222222222,30,4,0.13333333333333333,144,3,0.020833333333333332,3,0
Boyang Chen,67,7,0.1044776119402985,71,6,0.08450704225352113,137,4,0.029197080291970802,4,0
Konstantine Karantasis,31,6,0.1935483870967742,40,7,0.175,137,9,0.06569343065693431,7,2
David Arthur,31,2,0.06451612903225806,34,2,0.058823529411764705,126,3,0.023809523809523808,2,1
Grant Henke,29,4,0.13793103448275862,31,4,0.12903225806451613,124,2,0.016129032258064516,1,1
Chia-Ping Tsai,44,4,0.09090909090909091,46,4,0.08695652173913043,110,2,0.01818181818181818,1,1
Mickael Maison,17,0,0,17,0,0,104,0,0,0,0
Chris Egerton,55,4,0.07272727272727272,59,4,0.06779661016949153,103,4,0.038834951456310676,3,1
David Jacot,27,5,0.18518518518518517,35,5,0.14285714285714285,102,8,0.0784313725490196,6,2
Harsha,14,1,0.07142857142857142,15,2,0.13333333333333333,99,1,0.010101010101010102,1,0
Swapnil Ghike,51,8,0.1568627450980392,53,7,0.1320754716981132,97,2,0.020618556701030927,2,0
Ted Yu,19,1,0.05263157894736842,19,1,0.05263157894736842,83,0,0,0,0
Eno Thereska,24,4,0.16666666666666666,28,5,0.17857142857142858,82,4,0.04878048780487805,4,0
Tom Bentley,31,0,0,31,0,0,75,0,0,0,0
James Cheng,18,0,0,18,0,0,73,0,0,0,0
John Fung,44,7,0.1590909090909091,45,7,0.15555555555555556,62,1,0.016129032258064516,1,0
Apurva Mehta,36,3,0.08333333333333333,40,3,0.075,61,4,0.06557377049180328,4,0
Sriram,24,3,0.125,25,3,0.12,57,1,0.017543859649122806,1,0
Ashish Singh,29,1,0.034482758620689655,29,1,0.034482758620689655,55,0,0,0,0
Onur Karaman,23,3,0.13043478260869565,23,3,0.13043478260869565,54,0,0,0,0
Stanislav Kozlovski,12,2,0.16666666666666666,12,2,0.16666666666666666,53,0,0,0,0
Mayuresh Gharat,14,2,0.14285714285714285,14,2,0.14285714285714285,49,0,0,0,0
Jason Rosenberg,36,0,0,36,0,0,44,0,0,0,0
Dhruvil Shah,15,1,0.06666666666666667,16,1,0.0625,44,1,0.022727272727272728,1,0
Stevo Slavić,16,1,0.0625,16,1,0.0625,43,0,0,0,0
Anna Povzner,22,4,0.18181818181818182,22,4,0.18181818181818182,40,0,0,0,0
Geoff Anderson,27,5,0.18518518518518517,27,5,0.18518518518518517,40,0,0,0,0
Edoardo Comar,15,2,0.13333333333333333,17,2,0.11764705882352941,37,2,0.05405405405405406,2,0
Jose Armando Garcia Sancio,15,1,0.06666666666666667,16,1,0.0625,37,1,0.02702702702702703,0,1
dengziming,14,1,0.07142857142857142,14,1,0.07142857142857142,35,0,0,0,0
Ben Stopford,21,3,0.14285714285714285,22,2,0.09090909090909091,34,1,0.029411764705882353,0,1
Liquan Pei,13,4,0.3076923076923077,16,3,0.1875,34,3,0.08823529411764706,1,2
Xavier Léauté,23,5,0.21739130434782608,23,4,0.17391304347826086,30,0,0,0,0
Ron Dagostino,20,4,0.2,23,4,0.17391304347826086,30,3,0.1,3,0
Lucas Bradstreet,18,2,0.1111111111111111,18,2,0.1111111111111111,27,0,0,0,0
Bob Barrett,14,1,0.07142857142857142,14,1,0.07142857142857142,27,0,0,0,0
Dustin Cote,13,0,0,13,0,0,26,0,0,0,0
Seweryn Habdank-Wojewodzki,22,1,0.045454545454545456,22,1,0.045454545454545456,26,0,0,0,0
kaushik srinivas,19,0,0,19,0,0,23,0,0,0,0
Justine Olshan,10,2,0.2,11,2,0.18181818181818182,22,1,0.045454545454545456,1,0
Pengwei,15,3,0.2,15,3,0.2,18,0,0,0,0
jiamei xie,18,1,0.05555555555555555,18,0,0,18,0,0,0,0
Magnus Edenhill,10,1,0.1,10,1,0.1,18,0,0,0,0
M. Manna,5,1,0.2,10,2,0.2,18,5,0.2777777777777778,4,1
Tommy Becker,12,1,0.08333333333333333,12,0,0,17,0,0,0,0
Ryan P,11,0,0,11,0,0,16,0,0,0,0
Paolo Patierno,11,0,0,11,0,0,15,0,0,0,0
David Mao,9,0,0,10,0,0,15,1,0.06666666666666667,1,0
Bo Wang,9,2,0.2222222222222222,11,2,0.18181818181818182,15,2,0.13333333333333333,1,1
Stephane Maarek,10,1,0.1,10,0,0,15,0,0,0,0
Radai Rosenblatt,12,1,0.08333333333333333,12,1,0.08333333333333333,14,0,0,0,0
Andy Coates,10,0,0,10,0,0,14,0,0,0,0
Ivan Babrou,10,1,0.1,10,1,0.1,14,0,0,0,0
Magesh kumar Nandakumar,10,1,0.1,11,1,0.09090909090909091,13,1,0.07692307692307693,1,0
Raman Gupta,10,0,0,10,0,0,12,0,0,0,0
Evan Huus,10,0,0,10,0,0,12,0,0,0,0
Badai Aqrandista,10,1,0.1,11,1,0.09090909090909091,12,1,0.08333333333333333,1,0
Jeremy Custenborder,10,0,0,10,0,0,11,0,0,0,0
Ryan Berdeen,10,2,0.2,10,2,0.2,10,0,0,0,0
Yu Yang,9,3,0.3333333333333333,12,2,0.16666666666666666,10,3,0.3,1,2
Michael Drogalis,10,0,0,10,0,0,10,0,0,0,0
