Name,CreateCount,CreateCountC,CreatePercent,AssigneeCount,AssigneeCountC,AssigneePercent,Involvement,ModifyCount,ModifyPercent,IncModifyCount,DecModifyCount
Laszlo Kishalmi,57,1,0.017543859649122806,117,6,0.05128205128205128,1204,60,0.04983388704318937,9,51
Tomáš Procházka,40,0,0,40,0,0,703,0,0,0,0
Geertjan Wielenga,59,1,0.01694915254237288,67,1,0.014925373134328358,622,8,0.012861736334405145,3,5
Matthias Bläsing,31,1,0.03225806451612903,36,1,0.027777777777777776,347,5,0.01440922190201729,0,5
Junichi Yamamoto,32,0,0,45,3,0.06666666666666667,219,13,0.0593607305936073,6,7
Neil C Smith,13,1,0.07692307692307693,54,4,0.07407407407407407,189,41,0.21693121693121692,7,34
Christian Lenz,56,4,0.07142857142857142,70,7,0.1,171,14,0.08187134502923976,11,3
Svatopluk Dedic,97,2,0.020618556701030927,103,2,0.019417475728155338,166,6,0.03614457831325301,1,5
Jan Lahoda,20,0,0,21,0,0,139,1,0.007194244604316547,1,0
Jaroslav Tulach,54,2,0.037037037037037035,57,2,0.03508771929824561,118,3,0.025423728813559324,1,2
Eirik Bakke,49,3,0.061224489795918366,57,5,0.08771929824561403,114,8,0.07017543859649122,6,2
Jiří Kovalský,14,2,0.14285714285714285,22,4,0.18181818181818182,85,8,0.09411764705882353,6,2
Emilian Bold,53,0,0,53,0,0,77,0,0,0,0
Ernie Rael,50,6,0.12,60,6,0.1,76,10,0.13157894736842105,4,6
Eric Barboni,10,0,0,11,0,0,66,1,0.015151515151515152,0,1
ARUNAVA SINHA,27,0,0,27,0,0,63,0,0,0,0
Austin Stephens,58,10,0.1724137931034483,68,10,0.14705882352941177,61,10,0.16393442622950818,8,2
Reema Taneja,18,1,0.05555555555555555,19,1,0.05263157894736842,61,1,0.01639344262295082,0,1
John McDonnell,9,2,0.2222222222222222,11,2,0.18181818181818182,60,2,0.03333333333333333,0,2
Alessandro Falappa,18,0,0,19,0,0,47,1,0.02127659574468085,0,1
Netbeans User 2019,29,3,0.10344827586206896,32,3,0.09375,46,3,0.06521739130434782,2,1
Czukowski,34,1,0.029411764705882353,34,1,0.029411764705882353,43,0,0,0,0
Manikantan Narender Nath,34,2,0.058823529411764705,35,2,0.05714285714285714,41,1,0.024390243902439025,0,1
Aldo Brucale,35,4,0.11428571428571428,38,4,0.10526315789473684,38,3,0.07894736842105263,1,2
Gili,33,1,0.030303030303030304,33,1,0.030303030303030304,37,0,0,0,0
Shevek,36,0,0,36,0,0,37,0,0,0,0
aplatypus,34,3,0.08823529411764706,34,1,0.029411764705882353,35,0,0,0,0
Antonio Vieiro,18,2,0.1111111111111111,20,1,0.05,34,2,0.058823529411764705,0,2
Akhilesh Singh,18,0,0,18,0,0,31,0,0,0,0
Niklas Matthies,27,0,0,27,0,0,31,0,0,0,0
vikas kumar prabhakar,17,0,0,17,0,0,30,0,0,0,0
jose luis romero,26,3,0.11538461538461539,28,2,0.07142857142857142,30,2,0.06666666666666667,2,0
Rami Swailem,12,1,0.08333333333333333,12,1,0.08333333333333333,29,0,0,0,0
Gaurav Gupta,13,0,0,13,0,0,28,0,0,0,0
Bailey Campbell,25,1,0.04,26,1,0.038461538461538464,26,1,0.038461538461538464,0,1
S. M.,23,7,0.30434782608695654,35,7,0.2,26,12,0.46153846153846156,8,4
Michal Rama,25,6,0.24,30,6,0.2,25,5,0.2,4,1
Ruslan Lopez Carro,21,1,0.047619047619047616,22,1,0.045454545454545456,25,1,0.04,1,0
Martin Entlicher,19,2,0.10526315789473684,22,2,0.09090909090909091,25,3,0.12,2,1
Vano Beridze,23,0,0,23,0,0,24,0,0,0,0
Lars Bruun-Hansen,12,0,0,12,0,0,23,0,0,0,0
Pieter van den Hombergh,21,4,0.19047619047619047,23,4,0.17391304347826086,22,2,0.09090909090909091,2,0
David Gradwell,20,0,0,20,0,0,22,0,0,0,0
Anthony Vanelverdinghe,13,0,0,13,0,0,20,0,0,0,0
Rodrigo Teixeira Andreotti,19,2,0.10526315789473684,19,2,0.10526315789473684,19,0,0,0,0
Kenneth Fogel,16,0,0,16,0,0,19,0,0,0,0
Alexander Romanenko,16,4,0.25,20,4,0.2,18,4,0.2222222222222222,1,3
Peter Nabbefeld,16,3,0.1875,19,3,0.15789473684210525,18,3,0.16666666666666666,1,2
Benjamin Graf,14,2,0.14285714285714285,14,2,0.14285714285714285,18,0,0,0,0
Bernard,16,5,0.3125,21,6,0.2857142857142857,17,5,0.29411764705882354,5,0
Javier A. Ortiz,12,1,0.08333333333333333,14,1,0.07142857142857142,17,2,0.11764705882352941,1,1
Travis,15,2,0.13333333333333333,16,1,0.0625,17,1,0.058823529411764705,0,1
Vítězslav Dvořák,11,0,0,11,0,0,16,0,0,0,0
Tobias Warneke,14,2,0.14285714285714285,16,2,0.125,16,2,0.125,2,0
Scott Palmer,10,0,0,10,0,0,16,0,0,0,0
dennis lucero,13,0,0,13,0,0,16,0,0,0,0
Martin,16,0,0,16,0,0,16,0,0,0,0
Thomas Kellerer,11,0,0,11,0,0,15,0,0,0,0
Glenn Holmer,10,4,0.4,10,3,0.3,15,0,0,0,0
Luca Mambretti,11,1,0.09090909090909091,12,1,0.08333333333333333,15,1,0.06666666666666667,1,0
John Kostaras,11,0,0,11,0,0,14,0,0,0,0
Zsolt Holman,11,0,0,11,0,0,14,0,0,0,0
Brad Walker,13,0,0,13,0,0,13,0,0,0,0
Michal Owsiak,13,0,0,13,0,0,13,0,0,0,0
Peter,12,1,0.08333333333333333,12,0,0,13,0,0,0,0
Enrico Scantamburlo,11,0,0,11,0,0,12,0,0,0,0
Daniel Trebbien,10,0,0,10,0,0,12,0,0,0,0
Leo Donahue,12,0,0,12,0,0,12,0,0,0,0
Stephen Brooksbank,11,2,0.18181818181818182,13,2,0.15384615384615385,12,2,0.16666666666666666,1,1
Alexander,11,0,0,11,0,0,11,0,0,0,0
Bruce K. Haddon,11,0,0,11,0,0,11,0,0,0,0
Alessandro Polverini,11,0,0,11,0,0,11,0,0,0,0
Victor Pineda,11,0,0,11,0,0,11,0,0,0,0
Eugene Pliskin,11,1,0.09090909090909091,11,1,0.09090909090909091,11,0,0,0,0
NDelt,10,1,0.1,10,1,0.1,11,0,0,0,0
matteodg,9,2,0.2222222222222222,10,2,0.2,10,1,0.1,1,0
Heinz Schweitzer,10,1,0.1,10,0,0,10,0,0,0,0
Don,10,6,0.6,16,6,0.375,10,6,0.6,2,4
Vincenzo Luongo,10,0,0,10,0,0,10,0,0,0,0
Alied Pérez Martínez,6,2,0.3333333333333333,10,2,0.2,7,4,0.5714285714285714,2,2
