Name,CreateCount,CreateCountC,CreatePercent,AssigneeCount,AssigneeCountC,AssigneePercent,Involvement,ModifyCount,ModifyPercent,IncModifyCount,DecModifyCount
Sean R. Owen,68,3,0.04411764705882353,588,37,0.06292517006802721,4379,520,0.1187485727335008,32,488
Hyukjin Kwon,141,9,0.06382978723404255,346,25,0.07225433526011561,3315,205,0.06184012066365008,23,182
Dongjoon Hyun,282,33,0.11702127659574468,407,42,0.10319410319410319,1573,125,0.07946598855689765,83,42
Xiao Li,237,20,0.08438818565400844,293,25,0.08532423208191127,1513,56,0.037012557832121616,47,9
Wenchen Fan,239,16,0.06694560669456066,252,16,0.06349206349206349,1425,13,0.009122807017543859,7,6
Michael Armbrust,200,14,0.07,302,23,0.076158940397351,1029,102,0.09912536443148688,93,9
Reynold Xin,106,5,0.04716981132075472,158,8,0.05063291139240506,1014,52,0.05128205128205128,40,12
Josh Rosen,246,34,0.13821138211382114,297,40,0.13468013468013468,984,51,0.051829268292682924,42,9
Marcelo Masiero Vanzin,182,10,0.054945054945054944,208,10,0.04807692307692308,842,26,0.030878859857482184,10,16
Takeshi Yamamuro,38,2,0.05263157894736842,44,2,0.045454545454545456,807,6,0.007434944237918215,0,6
Patrick Wendell,98,16,0.16326530612244897,209,30,0.14354066985645933,755,111,0.14701986754966886,88,23
Andrew Or,237,22,0.09282700421940929,315,29,0.09206349206349207,726,78,0.10743801652892562,63,15
Yin Huai,206,35,0.16990291262135923,279,40,0.14336917562724014,632,73,0.11550632911392406,47,26
Shixiong Zhu,228,27,0.11842105263157894,244,25,0.10245901639344263,573,16,0.027923211169284468,9,7
L. C. Hsieh,138,7,0.050724637681159424,150,5,0.03333333333333333,557,12,0.02154398563734291,5,7
Davies Liu,199,17,0.08542713567839195,232,20,0.08620689655172414,540,33,0.06111111111111111,24,9
Cheng Lian,197,27,0.13705583756345177,221,30,0.13574660633484162,461,24,0.052060737527114966,20,4
Thomas Graves,148,11,0.07432432432432433,166,11,0.06626506024096386,385,18,0.046753246753246755,15,3
Herman van Hövell,53,3,0.05660377358490566,65,4,0.06153846153846154,382,12,0.031413612565445025,5,7
Yuming Wang,117,10,0.08547008547008547,118,9,0.07627118644067797,357,1,0.0028011204481792717,0,1
Xiangrui Meng,101,20,0.19801980198019803,132,20,0.15151515151515152,356,31,0.08707865168539326,22,9
Tathagata Das,107,17,0.1588785046728972,123,18,0.14634146341463414,332,16,0.04819277108433735,11,5
Kousuke Saruta,204,14,0.06862745098039216,208,12,0.057692307692307696,298,4,0.013422818791946308,3,1
Joseph K. Bradley,77,6,0.07792207792207792,97,7,0.07216494845360824,276,20,0.07246376811594203,10,10
Saisai Shao,70,10,0.14285714285714285,81,9,0.1111111111111111,270,11,0.040740740740740744,2,9
Shivaram Venkataraman,37,1,0.02702702702702703,38,1,0.02631578947368421,231,1,0.004329004329004329,1,0
Jungtaek Lim,72,3,0.041666666666666664,86,3,0.03488372093023256,231,14,0.06060606060606061,7,7
Marco Gaido,25,5,0.2,32,8,0.25,228,7,0.03070175438596491,0,7
Felix Cheung,94,5,0.05319148936170213,98,5,0.05102040816326531,219,4,0.0182648401826484,0,4
Holden Karau,56,5,0.08928571428571429,58,6,0.10344827586206896,196,2,0.01020408163265306,1,1
Max Gekk,98,5,0.05102040816326531,100,4,0.04,188,2,0.010638297872340425,0,2
Steve Loughran,29,5,0.1724137931034483,36,5,0.1388888888888889,184,7,0.03804347826086957,1,6
Matei Alexandru Zaharia,26,2,0.07692307692307693,38,4,0.10526315789473684,176,12,0.06818181818181818,5,7
Imran Rashid,45,6,0.13333333333333333,53,7,0.1320754716981132,156,8,0.05128205128205128,7,1
Kent Yao,113,8,0.07079646017699115,113,8,0.07079646017699115,136,0,0,0,0
Nicholas Chammas,32,4,0.125,33,4,0.12121212121212122,129,1,0.007751937984496124,1,0
Takuya Ueshin,94,3,0.031914893617021274,94,3,0.031914893617021274,128,0,0,0,0
Kazuaki Ishizaki,35,2,0.05714285714285714,35,1,0.02857142857142857,124,0,0,0,0
Bryan Cutler,26,4,0.15384615384615385,26,3,0.11538461538461539,115,0,0,0,0
Gengliang Wang,45,1,0.022222222222222223,49,1,0.02040816326530612,112,4,0.03571428571428571,1,3
Kay Ousterhout,50,8,0.16,54,6,0.1111111111111111,107,4,0.037383177570093455,1,3
Aaron Davidson,49,7,0.14285714285714285,50,7,0.14,106,1,0.009433962264150943,1,0
Guoqiang Li,46,8,0.17391304347826086,52,10,0.19230769230769232,105,6,0.05714285714285714,6,0
angerszhu,55,3,0.05454545454545454,55,3,0.05454545454545454,100,0,0,0,0
Gabor Somogyi,37,3,0.08108108108108109,40,4,0.1,98,3,0.030612244897959183,0,3
Burak Yavuz,65,3,0.046153846153846156,65,3,0.046153846153846156,92,0,0,0,0
Andrew Ash,22,4,0.18181818181818182,23,3,0.13043478260869565,92,1,0.010869565217391304,1,0
Cheng Hao,55,5,0.09090909090909091,56,4,0.07142857142857142,86,1,0.011627906976744186,1,0
Yanbo Liang,32,6,0.1875,35,5,0.14285714285714285,82,3,0.036585365853658534,3,0
Prashant Sharma,35,4,0.11428571428571428,37,4,0.10810810810810811,78,2,0.02564102564102564,0,2
wuyi,44,3,0.06818181818181818,46,3,0.06521739130434782,78,2,0.02564102564102564,1,1
Nan Zhu,27,11,0.4074074074074074,29,10,0.3448275862068966,77,2,0.025974025974025976,1,1
Sandy Ryza,27,4,0.14814814814814814,29,5,0.1724137931034483,73,2,0.0273972602739726,2,0
Dilip Biswal,32,0,0,32,0,0,71,0,0,0,0
Adrian Wang,33,3,0.09090909090909091,34,3,0.08823529411764706,70,1,0.014285714285714285,1,0
Sameer Agarwal,19,1,0.05263157894736842,25,1,0.04,70,6,0.08571428571428572,5,1
Mridul Muralidharan,13,0,0,14,0,0,65,1,0.015384615384615385,1,0
Maciej Szymkiewicz,45,2,0.044444444444444446,45,2,0.044444444444444446,64,0,0,0,0
Ryan Blue,39,4,0.10256410256410256,39,3,0.07692307692307693,64,0,0,0,0
Bruce Robbins,45,3,0.06666666666666667,46,3,0.06521739130434782,64,1,0.015625,0,1
shahid,17,2,0.11764705882352941,20,2,0.1,63,3,0.047619047619047616,2,1
Xingbo Jiang,14,3,0.21428571428571427,15,3,0.2,61,1,0.01639344262295082,1,0
t oo,17,2,0.11764705882352941,17,2,0.11764705882352941,60,0,0,0,0
Sun Rui,18,0,0,18,0,0,59,0,0,0,0
Yang Jie,34,2,0.058823529411764705,35,2,0.05714285714285714,57,1,0.017543859649122806,0,1
Maciej Bryński,33,7,0.21212121212121213,39,9,0.23076923076923078,57,6,0.10526315789473684,6,0
Lantao Jin,35,0,0,36,1,0.027777777777777776,56,1,0.017857142857142856,0,1
koert kuipers,36,5,0.1388888888888889,37,5,0.13513513513513514,55,1,0.01818181818181818,0,1
Jacek Laskowski,40,8,0.2,40,8,0.2,54,0,0,0,0
Fei Wang,48,7,0.14583333333333334,48,7,0.14583333333333334,54,0,0,0,0
Mark Hamstra,10,2,0.2,11,2,0.18181818181818182,52,1,0.019230769230769232,1,0
Weichen Xu,41,7,0.17073170731707318,43,7,0.16279069767441862,52,2,0.038461538461538464,1,1
DB Tsai,14,1,0.07142857142857142,16,2,0.125,51,2,0.0392156862745098,2,0
Stavros Kontopoulos,25,4,0.16,30,4,0.13333333333333333,51,5,0.09803921568627451,0,5
ABHISHEK KUMAR GUPTA,50,3,0.06,50,3,0.06,50,0,0,0,0
Jeff Zhang,17,2,0.11764705882352941,20,2,0.1,50,3,0.06,3,0
Genmao Yu,25,5,0.2,25,4,0.16,50,0,0,0,0
Yuanjian Li,24,4,0.16666666666666666,24,4,0.16666666666666666,49,0,0,0,0
meiyoula,41,4,0.0975609756097561,41,2,0.04878048780487805,47,0,0,0,0
Shane Knapp,16,0,0,17,0,0,46,1,0.021739130434782608,0,1
Ankur Dave,17,0,0,17,0,0,43,0,0,0,0
Ryan Williams,35,4,0.11428571428571428,37,4,0.10810810810810811,43,2,0.046511627906976744,0,2
Attila Zsolt Piros,23,1,0.043478260869565216,23,1,0.043478260869565216,42,0,0,0,0
Song Jun,23,0,0,23,0,0,41,0,0,0,0
Tao Wang,33,5,0.15151515151515152,34,5,0.14705882352941177,41,1,0.024390243902439025,1,0
Hossein Falaki,33,5,0.15151515151515152,35,5,0.14285714285714285,41,2,0.04878048780487805,1,1
Ajith S,19,4,0.21052631578947367,19,4,0.21052631578947367,40,0,0,0,0
carlmartin,36,5,0.1388888888888889,36,5,0.1388888888888889,38,0,0,0,0
Devaraj Kavali,17,2,0.11764705882352941,17,2,0.11764705882352941,38,0,0,0,0
XiDuo You,27,1,0.037037037037037035,27,1,0.037037037037037035,38,0,0,0,0
Hari Shreedharan,24,1,0.041666666666666664,24,1,0.041666666666666664,37,0,0,0,0
Jin Xing,28,1,0.03571428571428571,29,1,0.034482758620689655,36,1,0.027777777777777776,0,1
cen yuhai,28,5,0.17857142857142858,32,5,0.15625,36,4,0.1111111111111111,1,3
Lianhui Wang,19,1,0.05263157894736842,19,1,0.05263157894736842,36,0,0,0,0
Eric Liang,23,1,0.043478260869565216,23,1,0.043478260869565216,35,0,0,0,0
Matt Cheah,20,4,0.2,23,4,0.17391304347826086,34,3,0.08823529411764706,3,0
Ted Yu,27,3,0.1111111111111111,28,3,0.10714285714285714,33,1,0.030303030303030304,1,0
Daniel Darabos,15,3,0.2,17,3,0.17647058823529413,32,2,0.0625,2,0
Dragos Dascalita Haut,12,2,0.16666666666666666,13,2,0.15384615384615385,32,1,0.03125,1,0
Ruslan Dautkhanov,10,3,0.3,11,3,0.2727272727272727,32,1,0.03125,0,1
KaiXinXIaoLei,26,5,0.19230769230769232,26,5,0.19230769230769232,31,0,0,0,0
Yi Zhou,21,3,0.14285714285714285,22,3,0.13636363636363635,30,1,0.03333333333333333,1,0
Juliusz Sompolski,25,1,0.04,25,1,0.04,30,0,0,0,0
Miao Wang,12,0,0,12,0,0,30,0,0,0,0
Wei Xue,25,1,0.04,25,1,0.04,30,0,0,0,0
Sean Zhong,19,1,0.05263157894736842,19,1,0.05263157894736842,29,0,0,0,0
zhengruifeng,19,4,0.21052631578947367,20,4,0.2,29,1,0.034482758620689655,0,1
Terry Kim,19,1,0.05263157894736842,20,1,0.05,28,1,0.03571428571428571,0,1
yuhao yang,10,2,0.2,11,2,0.18181818181818182,28,1,0.03571428571428571,1,0
Zhan Zhang,18,1,0.05555555555555555,18,1,0.05555555555555555,28,0,0,0,0
Masayoshi Tsuzuki,14,1,0.07142857142857142,14,1,0.07142857142857142,28,0,0,0,0
Chao Sun,7,1,0.14285714285714285,10,2,0.2,27,3,0.1111111111111111,3,0
Simeon Simeonov,22,2,0.09090909090909091,23,2,0.08695652173913043,27,1,0.037037037037037035,0,1
Vinod KC,12,2,0.16666666666666666,12,2,0.16666666666666666,26,0,0,0,0
Yikun Jiang,21,1,0.047619047619047616,21,1,0.047619047619047616,26,0,0,0,0
Barry Becker,17,3,0.17647058823529413,19,3,0.15789473684210525,26,2,0.07692307692307693,0,2
dzcxzl,17,1,0.058823529411764705,17,1,0.058823529411764705,25,0,0,0,0
Weizhong,18,3,0.16666666666666666,18,3,0.16666666666666666,25,0,0,0,0
Zhenhua Wang,23,0,0,23,0,0,25,0,0,0,0
JESSE CHEN,19,1,0.05263157894736842,19,1,0.05263157894736842,25,0,0,0,0
Jose Torres,18,0,0,18,0,0,24,0,0,0,0
yucai,20,2,0.1,20,2,0.1,24,0,0,0,0
Tejas Patil,16,2,0.125,16,2,0.125,24,0,0,0,0
Mark Grover,16,1,0.0625,16,1,0.0625,24,0,0,0,0
Santiago M. Mola,13,1,0.07692307692307693,15,1,0.06666666666666667,24,2,0.08333333333333333,2,0
Nishkam Ravi,21,9,0.42857142857142855,21,7,0.3333333333333333,24,0,0,0,0
Sital Kedia,19,0,0,19,0,0,24,0,0,0,0
zuotingbing,20,5,0.25,22,5,0.22727272727272727,24,2,0.08333333333333333,2,0
Michael Gummelt,11,1,0.09090909090909091,11,1,0.09090909090909091,23,0,0,0,0
Carson Wang,18,4,0.2222222222222222,18,4,0.2222222222222222,23,0,0,0,0
liuxian,22,5,0.22727272727272727,24,5,0.20833333333333334,22,2,0.09090909090909091,2,0
pin_zhang,21,2,0.09523809523809523,21,0,0,22,0,0,0,0
Kris Mok,17,1,0.058823529411764705,17,1,0.058823529411764705,22,0,0,0,0
sam,13,3,0.23076923076923078,14,2,0.14285714285714285,22,1,0.045454545454545456,0,1
Xusen Yin,15,2,0.13333333333333333,15,2,0.13333333333333333,21,0,0,0,0
feiwang,14,1,0.07142857142857142,14,1,0.07142857142857142,21,0,0,0,0
Michael MacFadden,13,3,0.23076923076923078,15,3,0.2,21,2,0.09523809523809523,1,1
guoxiaolong,10,2,0.2,10,2,0.2,21,0,0,0,0
shenh062326,18,0,0,18,0,0,20,0,0,0,0
liupengcheng,20,3,0.15,20,3,0.15,20,0,0,0,0
SuYan,17,5,0.29411764705882354,18,3,0.16666666666666666,19,1,0.05263157894736842,0,1
Nattavut Sutyanyong,10,1,0.1,10,1,0.1,19,0,0,0,0
jiaan.geng,16,0,0,16,0,0,19,0,0,0,0
roncenzhao,15,0,0,15,0,0,19,0,0,0,0
marymwu,17,1,0.058823529411764705,17,1,0.058823529411764705,18,0,0,0,0
Russell Spitzer,10,1,0.1,10,0,0,18,0,0,0,0
Bogdan Raducanu,16,1,0.0625,16,1,0.0625,18,0,0,0,0
Bjørn Jørgensen,18,1,0.05555555555555555,18,1,0.05555555555555555,18,0,0,0,0
Jianshi Huang,14,4,0.2857142857142857,14,3,0.21428571428571427,18,0,0,0,0
Zhongshuai Pei,16,1,0.0625,16,0,0,18,0,0,0,0
Alex Liu,16,1,0.0625,16,1,0.0625,18,0,0,0,0
Yesha Vora,18,3,0.16666666666666666,18,3,0.16666666666666666,18,0,0,0,0
Chetan Bhat,18,0,0,18,0,0,18,0,0,0,0
Tanel Kiis,12,1,0.08333333333333333,12,1,0.08333333333333333,17,0,0,0,0
Egor Pahomov,16,3,0.1875,16,3,0.1875,17,0,0,0,0
Nong Li,10,1,0.1,10,1,0.1,16,0,0,0,0
Charles R Allen,9,1,0.1111111111111111,10,1,0.1,16,1,0.0625,0,1
Peter George Robbins,10,4,0.4,11,4,0.36363636363636365,16,1,0.0625,0,1
StanZhai,15,5,0.3333333333333333,17,4,0.23529411764705882,16,2,0.125,1,1
Parth Gandhi,13,2,0.15384615384615385,13,2,0.15384615384615385,15,0,0,0,0
Jacek Lewandowski,10,1,0.1,10,1,0.1,15,0,0,0,0
YanTang Zhai,14,1,0.07142857142857142,14,1,0.07142857142857142,15,0,0,0,0
Yana Kadiyska,10,2,0.2,10,2,0.2,15,0,0,0,0
Bago Amirbekian,11,3,0.2727272727272727,12,2,0.16666666666666666,15,1,0.06666666666666667,0,1
Aniket Bhatnagar,12,2,0.16666666666666666,12,2,0.16666666666666666,15,0,0,0,0
Jurriaan Pruis,10,3,0.3,10,1,0.1,14,0,0,0,0
Yadong Qi,13,1,0.07692307692307693,13,1,0.07692307692307693,14,0,0,0,0
jobit mathew,13,0,0,13,0,0,14,0,0,0,0
Feynman Liang,13,3,0.23076923076923078,13,3,0.23076923076923078,14,0,0,0,0
"Zhang, Liye",10,1,0.1,10,1,0.1,14,0,0,0,0
Jack Hu,13,2,0.15384615384615385,13,2,0.15384615384615385,13,0,0,0,0
Linhong Liu,12,0,0,12,0,0,13,0,0,0,0
Robert Joseph Evans,10,5,0.5,12,3,0.25,12,2,0.16666666666666666,1,1
Shardul Mahadik,10,1,0.1,10,1,0.1,12,0,0,0,0
N Campbell,11,1,0.09090909090909091,11,1,0.09090909090909091,12,0,0,0,0
Brad Willard,11,0,0,11,0,0,12,0,0,0,0
Trystan Leftwich,10,3,0.3,10,3,0.3,12,0,0,0,0
Allison Wang,12,0,0,12,0,0,12,0,0,0,0
iteblog,12,0,0,12,0,0,12,0,0,0,0
Wayne Zhang,11,1,0.09090909090909091,11,1,0.09090909090909091,12,0,0,0,0
Franklyn Dsouza,10,2,0.2,11,1,0.09090909090909091,12,1,0.08333333333333333,1,0
Andrew Davidson,12,2,0.16666666666666666,12,2,0.16666666666666666,12,0,0,0,0
William Hyun,11,0,0,11,0,0,11,0,0,0,0
Adrian Bridgett,10,0,0,10,0,0,11,0,0,0,0
Rajesh Balamohan,10,1,0.1,10,0,0,10,0,0,0,0
